1,1,1,1,1,1,1,1,1,1,1,1,1,1,1,1,1,1,1,1,1,1,1,1,1
1,0,0,0,0,0,0,5,0,0,0,0,0,5,0,0,0,4,0,0,0,5,0,0,1
1,0,0,0,0,0,0,5,0,0,0,0,0,5,0,0,0,4,0,0,0,5,0,0,1
1,1,1,1,1,1,1,1,1,1,1,1,1,1,1,1,1,1,1,1,1,1,0,0,1
1,0,0,0,0,0,0,5,0,0,0,0,0,0,0,4,0,5,0,0,0,1,0,0,1
1,0,0,0,0,0,0,5,0,0,0,0,0,0,0,4,0,5,0,0,0,1,0,0,1
1,4,4,1,1,1,1,1,1,1,1,1,1,1,1,1,1,1,1,0,0,1,0,0,1
1,0,0,1,0,0,0,0,0,0,0,0,3,3,3,0,5,2,1,0,0,1,0,0,1
1,0,0,1,0,0,0,0,0,0,0,0,3,3,3,0,5,5,1,0,0,1,5,5,1
1,0,0,1,0,0,1,1,1,1,1,1,1,1,1,1,1,1,1,5,5,1,0,0,1
1,0,0,1,0,0,0,5,0,0,0,0,0,0,0,0,0,0,0,0,0,1,0,0,1
1,0,0,1,0,0,0,5,0,0,0,0,0,0,0,0,0,0,0,0,0,1,4,4,1
1,5,5,1,1,1,1,1,1,1,1,1,1,1,1,1,1,1,1,1,1,1,0,0,1
1,0,0,0,0,0,0,0,0,0,5,0,0,0,4,0,0,0,0,0,5,0,0,0,1
1,0,0,0,0,0,0,0,0,0,5,0,0,0,4,0,0,0,0,0,5,0,0,0,1
1,1,1,1,1,1,1,1,1,1,1,1,1,1,1,1,1,1,1,1,1,1,1,1,1