1,1,1,1,1,1,1,1,1,1,1,1,1,1,1,1,1,1,1,1,1,1,1,1,1
1,0,0,0,0,5,5,0,0,0,0,0,5,5,0,0,5,5,0,0,5,5,4,3,1
1,0,0,0,0,5,5,0,0,0,0,0,5,5,0,0,5,5,0,0,5,5,4,3,1
1,5,5,1,1,1,1,1,1,1,1,1,1,1,0,0,1,1,1,1,1,1,1,1,1
1,5,5,1,1,1,1,1,1,1,1,1,1,1,5,5,1,1,1,1,1,1,1,1,1
1,0,0,0,5,5,0,0,5,5,4,3,1,1,0,0,5,5,0,0,5,5,4,3,1
1,0,0,0,5,5,0,0,5,5,4,3,1,1,0,0,5,5,0,0,5,5,4,3,1
1,5,5,1,1,1,1,1,1,1,1,1,1,1,0,0,1,1,1,1,1,1,1,1,1
1,5,5,1,1,1,1,1,1,1,1,1,1,1,5,5,1,1,1,1,1,1,1,1,1
1,0,0,0,5,5,0,0,5,5,4,3,1,1,0,0,5,5,0,0,5,5,4,3,1
1,0,0,0,5,5,0,0,5,5,4,3,1,1,0,0,5,5,0,0,5,5,4,3,1
1,5,5,1,1,1,1,1,1,1,1,1,1,1,0,0,1,1,1,1,1,1,1,1,1
1,5,5,1,1,1,1,1,1,1,1,1,1,1,5,5,1,1,1,1,1,1,1,1,1
1,0,0,0,5,5,0,0,0,0,0,0,1,1,0,0,0,0,0,0,0,0,0,0,1
1,0,0,0,5,5,0,0,0,0,0,0,2,1,0,0,0,0,0,0,0,0,0,0,1
1,1,1,1,1,1,1,1,1,1,1,1,1,1,1,1,1,1,1,1,1,1,1,1,1